11111111111111111111111111111
10010000000000010C00100000001
1001011111000010000110000E001
10001100000011110000000000001
10001000000001111000000000001
1000100000000110000110C000001
10000000000000000000011000001
111111110011000P0000001111111
10000000001100000000000000001
1000000001100000000000C000011
11111111111111111111111111111
