1111111111111111
10C1000000C110C1
1010011111000011
1000110000001111
1C0E1C00000000P1
1111111111111111
