1111111111
10010E1001
101000P001
1000C00101
1111111111

